15 7
YYYY YYYY YYYY YYYY YYYY YYYY YYYY YYYY YYYY YYYY YYYY YYYY YYYY YYYY YYYY
YYYY YYYY YYYY YYYY YYYY YYYY YYYY YYYY YYYY YYYY YYYY YYYY YYYY YYYY YYYY
YYYY YYYY YYYY YYGG YYYY YYYY YYYY YYYY YYYY YYYY YYYY YYYY YYYY YYYY YYYY
GGGG GGGG GGGG GGGG GGGG GGGG GGGG GGGG GGGG GGGG GGGG GGGG GGGG GGGG GGGG
GGGG GGGG GGGG GGGG GGGG GGGG GGGG GGGG GGGG GGGG GGGG GGGG GGGG GGGG GGGG
CCCC CCCC CCCC CCCC CCCC CCCC CCCC CCCC CCCC CCCC CCCC GGCC CCCC CCCC CCCC
CCCC CCCC CCCC CCCC CCCC CCCC CCCC CCCC CCCC CCCC CCCC CCCC CCCC CCCC CCCC

#Player start

PLAYER 0 0 NORTH true false

#NPCs

#Items

LOOT 1 2 0 false CENT
LOOT 2 4 3 false DOLLAR
LOOT 5 8 2 false RUBY
CLOCK 3 6 1 false 8
LEVER 4 13 4 false GREEN
LEVER 4 1 6 false RED
GATE 6 11 5 false GREEN
GATE 4 13 6 false RED
GATE 4 14 6 false RED
DOOR 8 2 6 false

#Exit tiles

EXIT 2 6

#Time limit

TIME 80