15 7
YYYY YYYY YYYY YYYY YYYY YYYY YYYY YYYY YYYY YYYY YYYY YYYY YYYY YYYY YYYY
YYYY YYYY YYYY YYYY YYYY YYYY YYYY YYYY YYYY YYYY YYYY YYYY YYYY YYYY YYYY
YYYY YYYY YYYY YYYY YYYY YYYY YYYY YYYY YYYY YYYY YYYY YYYY YYYY YYYY YYYY
GGGG GGGG GGGG YYYY YYYY YYYY RRRR RRRR YYYY YYYY YYYY YYYY YYYY YYYY YYYY
GGGG GGGG GGRR YYYY YYYY YYYY RRRR RRRR YYYY YYYY YYYY YYYY YYYY YYYY YYYY
GGGG GGGG YYYY YYYY YYYY YYYY YYYY YYRR YYYY YYYY YYYY YYYY YYYY YYYY YYYY
GGGG GGGG YYYY YYYY YYYY YYYY RRRR RRRR YYYY YYYY YYYY YYYY YYYY YYYY YYYY

# Player start

PLAYER 0 0 NORTH true false

# NPCs

ASSASSIN 13 1 SOUTH true false

# Items

LOOT 1 2 0 false CENT
LOOT 2 4 3 false DOLLAR
LOOT 5 8 2 false RUBY
LOOT 5 13 2 false DIAMOND
DOOR 8 0 6 false

# Exit tiles

EXIT 0 6

# Time limit

TIME 90
